TTTTTTTTTTT
TT ####  @T
T T ##    T
T   ##   CT
T         T
TG ####  KT
TTTTTTTTTTT