TTTTTTTTTT    TTTTT     TTTTT TTTT###TTT
T                                 @    T
T                                      T
T                                      T
T                                      T
T                                      T
T                                      T
T                                      T
T                                      T
T                                      T
T                                      T
T                                      T
T                                      T
T                                      T
T                                      T
T                                      T
T                                      T
T                                      T
T                                      T
T                                      T
T                                      T
T                                      T
T                                      T
T                                      T
T                                      T
T                                      T
T                                      T
T                                      T
T                                      T