TTTTTTTTT
T       T
T       T
T       T
T  C    T
T C@C   T
T  C    T
T       T
T       T