           K #########
 C #######   #########
   ######## ##########
########### ##########
####           ####   
#### B B     B B### G 
####           ####   
########### ##########
########### ##########
###########@##########
######################