TTTTTTTTT
T@C   # T
T     # T
T     # T
TTTTTTTTT